1111111111111111111111111111111111111111111111111111111111111111
1022000000000110000000000000000000000000000000000000000000000001
1022000000000110000000000000000000000000000000000000000000000001
1022222222222222222222222222222222222222222222222222222222222221
1022222222222222222222222222222222222222222222222222222222222221
1022000000000110000000000000000000000000000000000000002200000001
1022000000000110000000003330000000000000000000000000002200000001
1022000000000110000000033333333003000000000000000000002200000001
1022000000000110000000333333333033000000000000000000002200000001
1022000000000110000000033333330003300000000000000000002200000001
1122111111111111111111111111111111111111111111111111112211111111
1022000000000000000000000000000000000033303300000000000000000001
1022000000000000000000000000000000000003300000300000000000000001
1022000000000000000000000000000000000000000000000000000000000001
1222222222222222222222222222222222222222222222222222222222222221
1222222222222222222222222222222222222222222222222222222222222221
1000000000000000000000000000000000000000000011122111000000000001
1000000000000000000000000000000000000000000014444441000000000001
1000000000000000000000000000000000000000000014444441000000000001
1000000000000000000000000000000000000000000014444441000000000001
1000000000000000000000000000000000000000000014444441000000000001
1000000000000000000000000000000000001111111114444441000000000001
1000000000000000000000000000000000001444444444444441000000000001
1000000000000000000000000000000000001444444444444441000000000001
1000000000000000000000000000000000001444444444444441000000000001
1000000000000000000000000000000000001111111111111111000000000001
1000000000000000000000000000000000000000000000000000000000000001
1000000000000000000000000000000000000000000000000000000000000001
1000000000000000000000000000000000000000000000000000000000000001
1000000000000000000000000000000000000000000000000000000000000001
1000000000000000000000000000000000000000000000000000000000000001
1000000000000000000000000000000000000000000000000000000000000001
1000000000000000000000000000000000000000000000000000000000000001
1111111111111111111133311111111111111111111111111111111111111111
1111111111111111111133311111111111111111111111111111111111111111
1111111111111111111133311111111111111111111111111111111111111111
1111111111111111111133311111111111111111111111111111111111111111
1113333333333333311333333333333333333333333333333333333333333111
1113333333333333311333333333333333333333333333333333333333333111
1113333333333333311111133333333333333333333333333333333333333111
1113333333333333333111111113333333333333333333333333333333333111
1113333333333333333333333333333333333333333333333333333333333111
1111133333333333333333333333333333333333333333333333333333333111
1111111113333333333333333333333333333333333333333333333333333111
1113333113333333333333333333333333333333333333333333333333333111
1113333113333333333333333333333333333333333333333333333333333111
1113333113333333333333333333333333333333333333333333333333333111
1113333333333333333333333333333333333333333333333333333333333111
1113333333333333333333333333333333333333333333333333333333333111
1113333333333333333333333333333333333333333333333333333333333111
1113333333333333333333333333333333333333333333333333333333333111
1113333333333333333333333333333333333333333333333333333333333111
1113333333333333333333333333333333333333333333333333333333333111
1113333333333333333333333333333333333333333333333333333333333111
1113333333333333333333333333333333333333333333333333333333333111
1113333333333333333333333333333333333333333333333333333333333111
1113333333333333133333333333333333333333333333333333333333333111
1113333333333331111111133333333333333333333333333333333333333111
1113333333333331111113333333333333333333333333333333333333333111
1113333333333331133333333333333333333333333333333333333333333111
1113333333333331133333333333333333333333333333333333333333333111
1111111111111111111111111111111111111111111111111111111111111111
1111111111111111111111111111111111111111111111111111111111111111
1111111111111111111111111111111111111111111111111111111111111111