1111111111100111
1111111111100111
1100001110000011
1100000000000011
1111000000111111
1111000000111111
1100000000000011
1111110000001111
1111110000001111
1100000000000011
1111111110011111
1111111110011111