0000000000000000
0000000011111100
0000000014444100
0000000014444100
0000000014444100
0000000014444100
0000000011221100
0000000000220000
2222222222222222
0000000000000000
0000000000033333
0000000033333333